1, 2, 2, 2, 2, 2, 2, 2, 2, 2, 2, 2, 2, 2, 2, 3
4, 5, 6, 7, 8, 9, 7, 9, 7, 9, 10, 5, 11, 9, 12, 13
14, 15, 16, 17, 18, 19, 20, 21, 22, 21, 23, 15, 24, 25, 26, 27
28, 29, 30, 31, 18, 32, 17, 33, 34, 33, 35, 29, 36, 37, 38, 27
39, 40, 41, 42, 43, 44, 45, 46, 45, 46, 47, 48, 40, 41, 49, 50
51, 52, 53, 54, 55, 56, 57, 58, 57, 58, 59, 60, 61, 62, 63, 64
65, 65, 65, 65, 65, 65, 65, 65, 65, 65, 65, 65, 65, 66, 67, 68
